██████████████████████████████████████████████████████████████████
    ██                                                  ██      ██
██  ██  ██████████  ██  ██  ██  ██████  ██████████  ██  ██  ██████
██              ██  ██  ██  ██      ██          ██  ██      ██  ██
██  ██████████████  ██  ██████  ██  ██████  ██████████████  ██  ██
██              ██  ██  ██      ██      ██          ██  ██      ██
██  ██████████████  ██████████  ██████  ██  ██████  ██  ██████  ██
██          ██  ██      ██      ██  ██  ██      ██          ██  ██
██████  ██████  ██  ██  ██████████  ██  ██████████████████████████
██  ██          ██  ██          ██              ██  ██          ██
██  ██  ██  ██████████  ██  ██  ██████████  ██  ██  ██████  ██████
██      ██  ██  ██      ██  ██          ██  ██                  ██
██  ██████  ██  ██████  ██████  ██  ██████  ██████  ██████████  ██
██      ██      ██          ██  ██  ██      ██  ██  ██          ██
██████████  ██████  ██  ██████████  ██████  ██  ██  ██████████  ██
██              ██  ██          ██  ██  ██      ██  ██          ██
██████  ██  ██████  ██  ██  ██████████  ██████████  ██████████  ██
██      ██      ██  ██  ██              ██      ██  ██      ██  ██
██████  ██  ██  ██████  ██  ██  ██████  ██  ██████████████  ██  ██
██  ██  ██  ██      ██  ██  ██  ██  ██              ██          ██
██  ██  ██  ██  ██  ██████  ██████  ██  ██████  ██████  ██  ██  ██
██  ██  ██  ██  ██  ██              ██  ██          ██  ██  ██  ██
██  ██  ██  ██  ██████  ██  ██████████████████  ██████  ██  ██  ██
██      ██  ██  ██      ██                  ██      ██  ██  ██  ██
██████  ██████████████  ██████  ██████████████████  ██████  ██████
██          ██  ██      ██  ██              ██          ██      ██
██████  ██████  ██  ██  ██  ██  ██  ██  ██████  ██  ██████  ██████
██              ██  ██  ██      ██  ██  ██  ██  ██  ██          ██
██████  ██████████  ██  ██████████████████  ██████████████████████
██  ██          ██  ██                                  ██  ██  ██
██  ██  ██████████████████████  ██████  ██  ██████  ██████  ██  ██
██                      ██          ██  ██      ██                
██████████████████████████████████████████████████████████████████
