██████████████████████████████████████████
                    ██          ██  ██  ██
██  ██  ██  ██████  ██  ██████████  ██  ██
██  ██  ██      ██      ██      ██      ██
██  ██  ██████  ██████████████  ██  ██  ██
██  ██  ██  ██                      ██  ██
██  ██  ██  ██████  ██  ██  ██████  ██  ██
██  ██          ██  ██  ██      ██  ██  ██
██  ██████  ██  ██████  ██  ██  ██████████
██      ██  ██      ██  ██  ██          ██
██  ██████████████████  ██  ██  ██  ██  ██
██                  ██  ██  ██  ██  ██  ██
██  ██  ██  ██████  ██████████████████  ██
██  ██  ██      ██              ██      ██
██  ██████████████████  ██  ██████  ██  ██
██          ██      ██  ██      ██  ██  ██
██  ██  ██  ██  ██████  ██████████████  ██
██  ██  ██          ██      ██          ██
██  ██  ██  ██████████████████████  ██  ██
██  ██  ██                  ██      ██    
██████████████████████████████████████████