██████████████████████████████████████████████████████████████████████████████████████████████████████████████████████████████████████████████████████████████████
            ██                      ██      ██          ██      ██              ██          ██              ██          ██      ██                  ██      ██  ██
██████████  ██  ██████████████████  ██  ██  ██  ██  ██  ██  ██  ██████  ██████  ██████  ██  ██████████  ██  ██  ██████  ██  ██  ██  ██  ██████████  ██  ██  ██  ██
██          ██          ██      ██      ██  ██  ██  ██      ██          ██  ██  ██      ██          ██  ██  ██      ██      ██      ██          ██      ██      ██
██  ██████████████████  ██  ██  ██████████  ██████  ██████████████████████  ██  ██  ██████████████  ██  ██  ██████  ██████████████████████████  ██████████████  ██
██                  ██      ██          ██      ██      ██      ██      ██  ██      ██          ██  ██  ██  ██          ██      ██      ██      ██      ██      ██
██████████████████  ██████  ██████████  ██████  ██████  ██  ██  ██  ██  ██  ██████████  ██  ██  ██  ██  ██  ██████████  ██  ██  ██  ██  ██  ██████  ██████  ██████
██      ██      ██      ██          ██      ██          ██  ██      ██      ██          ██  ██  ██      ██          ██      ██  ██  ██      ██      ██      ██  ██
██  ██  ██  ██  ██████  ██████████  ██████  ██████████████  ██████████████  ██████████████  ██████████████████████  ██████  ██████  ██████████  ██████  ██████  ██
██  ██  ██  ██  ██      ██  ██      ██  ██  ██              ██          ██              ██                      ██      ██  ██      ██                  ██      ██
██  ██  ██  ██  ██  ██████  ██  ██████  ██  ██  ██████████████  ██████  ██████████████  ██  ██████████████  ██  ██████  ██████  ██████  ██████████████████  ██  ██
██  ██  ██  ██      ██                  ██  ██          ██      ██  ██              ██  ██      ██          ██  ██      ██      ██  ██      ██              ██  ██
██  ██████  ██████████████████████  ██████  ██  ██████  ██  ██████  ██████████████  ██  ██████████  ██████████  ██  ██████  ██████  ██████  ██  ██  ██████████████
██          ██  ██              ██  ██      ██  ██      ██      ██      ██      ██  ██  ██          ██  ██      ██      ██  ██              ██  ██              ██
██  ██████████  ██  ██  ██████  ██████  ██████████  ██████████  ██  ██████  ██  ██  ██  ██  ██████████  ██  ██████████  ██  ██████  ██████████████████████████  ██
██  ██              ██      ██          ██      ██      ██          ██      ██  ██  ██  ██          ██          ██      ██      ██                              ██
██  ██████████████████████  ██████████████  ██  ██████  ██  ██████████  ██████  ██  ██  ██████████  ██████████  ██  ██████  ██  ██████████████████████████████  ██
██      ██                  ██              ██      ██  ██      ██      ██  ██  ██                  ██      ██  ██      ██  ██  ██                  ██      ██  ██
██████  ██  ██████████████████  ██████████████████  ██  ██████████  ██████  ██  ██████████████████████  ██  ██████████  ██  ██  ██  ██████████  ██████  ██  ██  ██
██  ██  ██  ██          ██      ██          ██          ██      ██          ██                          ██  ██          ██  ██  ██  ██  ██      ██      ██  ██  ██
██  ██  ██  ██  ██  ██  ██  ██████  ██████  ██  ██████████  ██  ██████████  ██████████████████████████████  ██  ██████████████  ██  ██  ██  ██████  ██████  ██  ██
██  ██      ██  ██  ██      ██          ██      ██          ██          ██          ██                  ██      ██              ██      ██              ██      ██
██  ██████████  ██  ██  ██████████████████  ██████  ██████████████████  ██████████  ██  ██████████  ██████████████  ██  ██████████████  ██████████████  ██████████
██          ██  ██  ██  ██              ██      ██  ██          ██  ██  ██          ██      ██      ██          ██  ██  ██          ██  ██          ██      ██  ██
██  ██  ██████  ██  ██████  ██████████  ██████████  ██  ██  ██  ██  ██  ██  ██████████████  ██████████  ██████  ██  ██  ██  ██████  ██  ██  ██████  ██████  ██  ██
██  ██  ██      ██      ██  ██      ██              ██  ██  ██  ██  ██      ██              ██          ██  ██      ██  ██      ██  ██  ██      ██      ██      ██
██  ██  ██  ██████████  ██  ██  ██  ██████████████████████  ██  ██  ██████████████  ██████████  ██████████  ██████████  ██████  ██  ██  ██████  ██████  ██████  ██
██  ██  ██          ██      ██  ██  ██                      ██                  ██      ██      ██              ██      ██      ██  ██      ██      ██      ██  ██
██  ██  ██████████  ██████████  ██  ██  ██████████████  ██████████████████████  ██████  ██  ██████████████████  ██  ██████  ██████  ██  ██████████  ██████  ██████
██  ██      ██      ██          ██  ██      ██      ██                  ██              ██  ██                  ██      ██  ██  ██      ██          ██  ██      ██
██  ██████████  ██████████████  ██  ██████  ██  ██  ██████████████████  ██████████████  ██  ██  ██████████████  ██████  ██  ██  ██████████  ██████████  ██████  ██
██          ██  ██          ██  ██      ██      ██  ██              ██              ██  ██      ██      ██          ██  ██          ██      ██              ██  ██
██  ██████  ██  ██  ██████  ██  ██████████████████  ██  ██████████  ██████████████  ██████████████████  ██  ██████████  ██████████  ██  ██████  ██████████  ██  ██
██      ██      ██  ██  ██      ██          ██      ██          ██      ██          ██                  ██      ██      ██      ██  ██  ██      ██          ██  ██
██████  ██████████  ██  ██████  ██  ██  ██████  ██████████  ██  ██████  ██  ██████████  ██████████  ██  ██████  ██  ██████  ██  ██████  ██████████  ██████  ██  ██
██      ██          ██          ██  ██      ██          ██  ██      ██  ██      ██      ██      ██  ██      ██  ██          ██                  ██  ██  ██  ██  ██
██  ██████  ██  ██████████  ██████  ██████  ██████████  ██████  ██  ██████████  ██  ██████████  ██  ██████████  ██████████████████████████████  ██  ██  ██  ██  ██
██  ██      ██          ██      ██  ██  ██          ██      ██  ██          ██      ██          ██              ██          ██  ██      ██      ██  ██      ██  ██
██  ██████████████████  ██████████  ██  ██  ██████  ██████  ██  ██████  ██  ██████████  ██  ██  ██████████████████████  ██  ██  ██  ██  ██  ██████  ██  ██████  ██
██      ██          ██              ██  ██  ██      ██      ██  ██  ██  ██      ██      ██  ██          ██              ██      ██  ██  ██          ██      ██  ██
██████  ██  ██████  ██  ██████████████  ██  ██████████  ██████  ██  ██  ██████  ██████████  ██████████  ██████████  ██████████████  ██  ██████████████  ██████  ██
██      ██  ██      ██  ██              ██              ██  ██      ██  ██      ██          ██      ██      ██      ██      ██      ██      ██          ██      ██
██  ██████  ██  ██████  ██  ██████  ██  ██████████████████  ██  ██████  ██  ██████  ██████████████  ██████  ██  ██  ██  ██  ██  ██████████  ██████████████  ██  ██
██  ██      ██      ██  ██  ██      ██  ██          ██          ██      ██          ██              ██      ██  ██  ██  ██      ██      ██              ██  ██  ██
██  ██████  ██████  ██  ██████  ██████  ██  ██  ██  ██████████████  ██████████████████████  ██████  ██  ██████  ██  ██  ██████████████  ██████████████  ██  ██  ██
██      ██  ██      ██          ██  ██  ██  ██  ██  ██          ██  ██      ██              ██      ██  ██      ██  ██      ██      ██              ██      ██  ██
██████  ██  ██  ██████████████████  ██  ██████  ██  ██  ██████  ██  ██  ██  ██  ██  ██████████  ██████  ██  ██████  ██████  ██  ██  ██████  ██████  ██████████  ██
██  ██      ██  ██  ██                          ██      ██          ██  ██      ██  ██  ██          ██  ██  ██      ██      ██  ██      ██  ██              ██  ██
██  ██████████  ██  ██  ██████████████████████████████████████████████  ██████████  ██  ██  ██████████  ██  ██  ██████  ██  ██  ██████  ██  ██  ██████████████  ██
██      ██      ██      ██  ██                              ██      ██  ██      ██  ██  ██      ██      ██  ██  ██      ██  ██  ██  ██  ██  ██  ██              ██
██  ██████  ██████  ██████  ██  ██████████████████████████  ██████  ██  ██  ██████  ██  ██  ██████  ██████  ██████  ██  ██████  ██  ██  ██  ██  ██  ██████████  ██
██      ██      ██          ██      ██                  ██      ██      ██  ██      ██      ██      ██      ██      ██  ██          ██  ██  ██  ██  ██      ██  ██
██  ██  ██████  ██████████████  ██  ██████████  ██  ██████████  ██████  ██  ██  ██████  ██████  ██████  ██  ██  ██████████  ██████████  ██  ██████  ██  ██  ██  ██
██  ██  ██      ██          ██  ██          ██  ██          ██      ██  ██  ██      ██  ██      ██      ██  ██          ██  ██      ██  ██          ██  ██  ██  ██
██  ██  ██  ██████  ██████  ██████████████  ██  ██████  ██████████  ██  ██  ██████  ██  ██  ██████████  ██  ██████████  ██  ██  ██  ██  ██  ██████████  ██  ██████
██  ██      ██      ██  ██              ██  ██      ██              ██      ██      ██  ██              ██  ██      ██      ██  ██      ██      ██      ██      ██
██  ██████████  ██████  ██████████████  ██  ██████  ██████████████████████████  ██████  ██████████████████  ██  ██  ██████████  ██████████████  ██  ██████████  ██
██  ██      ██  ██      ██          ██      ██  ██  ██                          ██      ██      ██      ██      ██      ██  ██  ██          ██  ██          ██  ██
██  ██  ██  ██  ██  ██  ██  ██████  ██████████  ██  ██████████  ██████████████████  ██████  ██  ██  ██  ██████████████  ██  ██  ██  ██████  ██  ██████████  ██  ██
██      ██  ██  ██  ██      ██          ██      ██          ██              ██              ██  ██  ██      ██      ██      ██  ██      ██  ██  ██  ██      ██  ██
██████████  ██  ██  ██████████  ██████  ██  ██  ██████████  ██  ██████████  ██████████████████  ██████  ██  ██  ██  ██████  ██  ██  ██████  ██  ██  ██  ██████  ██
██  ██      ██  ██      ██      ██          ██          ██  ██      ██  ██  ██      ██                  ██  ██  ██  ██      ██      ██      ██      ██  ██  ██  ██
██  ██  ██████  ██  ██████  ██████████████████████████  ██  ██████  ██  ██  ██  ██  ██  ██████████████████  ██  ██  ██  ██████████████  ██████████████  ██  ██  ██
██  ██          ██  ██      ██          ██              ██  ██  ██  ██  ██      ██  ██      ██          ██  ██  ██          ██      ██          ██      ██  ██  ██
██  ██████████████  ██  ██████  ██████  ██████████████████  ██  ██  ██  ██████████  ██████████  ██████  ██  ██  ██████████████  ██  ██████  ██  ██  ██████  ██  ██
██                  ██  ██      ██  ██                      ██  ██      ██      ██              ██  ██  ██  ██      ██          ██      ██  ██              ██  ██
██  ██████████████████  ██  ██████  ██████████████████████████  ██████  ██  ██████████████████████  ██  ██████████  ██  ██████████████  ██  ██████████████████  ██
██                  ██  ██  ██          ██              ██          ██  ██  ██      ██              ██  ██          ██  ██          ██  ██      ██              ██
██████████████████  ██  ██  ██  ██  ██████  ██████  ██  ██████  ██  ██  ██  ██  ██  ██  ██  ██████  ██  ██  ██████████  ██████████  ██  ██████████  ██████████  ██
██              ██  ██      ██  ██      ██      ██  ██      ██  ██  ██  ██      ██      ██  ██      ██      ██  ██      ██      ██  ██  ██          ██          ██
██  ██████████  ██  ██████████████  ██  ██████  ██  ██████  ██  ██  ██  ██████  ██████████  ██  ██████████████  ██  ██████  ██  ██  ██  ██  ██████████  ██████████
██  ██      ██  ██  ██          ██  ██          ██      ██      ██  ██      ██          ██  ██          ██      ██  ██      ██  ██  ██      ██      ██  ██      ██
██  ██  ██  ██████  ██  ██████  ██████████████████  ██  ██████████████████  ██████████  ██  ██████████  ██████  ██  ██  ██████  ██  ██████████  ██  ██  ██  ██  ██
██      ██      ██      ██  ██                  ██  ██          ██      ██  ██          ██          ██          ██      ██      ██          ██  ██  ██      ██  ██
██  ██████████  ██████████  ██████████████████  ██  ██████████  ██  ██  ██  ██████████████████████  ██████████  ██████████  ██████  ██████  ██  ██  ██████████  ██
██  ██  ██                      ██          ██  ██          ██      ██          ██      ██          ██      ██      ██      ██  ██  ██  ██      ██  ██      ██  ██
██  ██  ██  ██████████████████████  ██████  ██  ██  ██████████████████████████  ██  ██  ██  ██████████  ██  ██████  ██  ██████  ██  ██  ██████████  ██  ██  ██  ██
██  ██  ██      ██      ██          ██  ██      ██  ██              ██      ██      ██      ██          ██  ██      ██      ██      ██  ██          ██  ██      ██
██  ██  ██████  ██  ██  ██  ██████████  ██████████████  ██████████  ██  ██  ██████████████████  ██████████  ██████████████  ██  ██████  ██  ██████████  ██████████
██          ██      ██                                  ██              ██                      ██                          ██          ██                        
██████████████████████████████████████████████████████████████████████████████████████████████████████████████████████████████████████████████████████████████████
